11111111111111111111111111111111
11...........................111
1..............M...............1
1..........................U...1
1..C...........................1
1.......11111......11111.......1
1.......1..............1.......1
1.......1...C..........1.......1
1.......1.........U....1.......1
1.......1..............1.......1
1..............................1
1....M.........11......C.......1
1..............11..............1
1..............................1
1.......1..............1.......1
1.......1.....C........1....M..1
1....U..1..........U...1.......1
1.......1..............1.......1
1.......11111......11111.......1
1..............................1
1........M................C....1
1..P...........................1
11.............U..............11
11111111111111111111111111111111
